SCL_NAME,SCL_DIVISION,SCL_CONFERENCE,FED_N_SA,FED_RATE_SA,GSR_N_SA,GSR_SA,FED_N_MALE_SA,FED_RATE_MALE_SA,FED_N_FEMALE_SA,FED_RATE_FEMALE_SA,GSR_N_MALE_SA,GSR_MALE_SA,GSR_N_FEMALE_SA,GSR_FEMALE_SA,FED_N_SB,FED_RATE_SB,FED_N_MALE_SB,FED_RATE_MALE_SB,FED_N_FEMALE_SB,FED_RATE_FEMALE_SB
Alabama A&M University,1,Southwestern Athletic Conf.,211,46,241,60,135,37,76,62,146,53,95,71,3998,30,1919,23,2079,36
University of Alabama at Birmingham,1,Conference USA,227,67,261,84,115,58,112,77,146,77,115,93,5850,54,2583,48,3267,59
Alabama State University,1,Southwestern Athletic Conf.,233,52,242,72,131,44,102,63,133,63,109,83,4727,26,2107,20,2620,31
University of Alabama,1,Southeastern Conference,322,70,331,89,151,64,171,76,160,87,171,92,21179,67,9512,63,11667,71
Auburn University,1,Southeastern Conference,378,66,365,84,196,60,182,73,199,77,166,92,16260,74,7835,69,8425,78
Jacksonville State University,1,Ohio Valley Conference,258,60,259,78,119,59,139,61,142,71,117,85,5093,34,2289,27,2804,39
Samford University,1,Southern Conference,236,72,205,97,133,72,103,72,116,96,89,98,2830,72,1010,67,1820,75
University of South Alabama,1,Sun Belt Conference,231,61,279,80,127,54,104,69,173,73,106,91,6686,37,3053,32,3633,42
Troy University,1,Sun Belt Conference,218,65,293,85,98,62,120,68,173,80,120,92,6642,37,2756,32,3886,41
Arizona State University,1,Pac-12 Conference,330,63,328,88,182,49,148,80,171,80,157,97,32841,64,16016,61,16825,68
University of Arizona,1,Pac-12 Conference,310,61,299,86,168,54,142,69,161,80,138,92,26771,61,12310,57,14461,64
Grand Canyon University,1,Western Athletic Conference,279,54,335,79,162,45,117,67,176,76,159,84,1815,40,660,35,1155,42
Northern Arizona University,1,Big Sky Conference,212,60,209,86,97,52,115,68,109,81,100,91,13547,53,5648,48,7899,57
University of Arkansas at Little Rock,1,Sun Belt Conference,146,57,161,82,43,49,103,60,72,78,89,85,2832,28,1228,27,1604,28
"University of Arkansas, Fayetteville",1,Southeastern Conference,341,55,311,79,182,41,159,70,154,68,157,91,14054,63,6931,59,7123,67
"University of Arkansas, Pine Bluff",1,Southwestern Athletic Conf.,161,48,185,71,88,41,73,58,114,60,71,90,3339,26,1558,22,1781,31
Arkansas State University,1,Sun Belt Conference,238,61,239,85,125,62,113,59,139,83,100,89,6548,41,2993,39,3555,44
University of Central Arkansas,1,Southland Conference,317,58,314,80,167,51,150,65,176,74,138,88,7596,43,3224,38,4372,47
California Polytechnic State University,1,Big West Conference,340,69,320,82,201,62,139,78,196,74,124,93,15139,81,8146,76,6993,86
"California State University, Bakersfield",1,Western Athletic Conference,209,49,177,79,89,51,120,48,89,80,88,78,4211,40,1555,37,2656,42
"California State University, Fresno",1,Mountain West Conference,249,67,242,86,122,53,127,80,117,77,125,94,10766,56,4343,50,6423,59
"California State University, Fullerton",1,Big West Conference,207,55,191,77,97,39,110,68,84,67,107,86,16204,61,6762,56,9442,65
Long Beach State University,1,Big West Conference,218,65,231,87,93,60,125,69,103,85,128,89,15909,67,6245,62,9664,70
"California State University, Northridge",1,Big West Conference,193,60,228,81,89,47,104,71,106,75,122,86,18790,50,8201,43,10589,55
"California State University, Sacramento",1,Big Sky Conference,288,56,314,75,135,45,153,66,157,68,157,83,11111,48,4555,41,6556,52
"University of California, Berkeley",1,Pac-12 Conference,481,70,466,82,208,59,273,79,204,75,262,87,17178,91,7977,89,9201,93
"University of California, Davis",1,Big West Conference,437,81,408,89,188,74,249,87,188,82,220,94,18525,85,7957,82,10568,87
"University of California, Irvine",1,Big West Conference,215,70,197,85,119,61,96,80,101,80,96,91,18078,87,7862,84,10216,88
"University of California, Los Angeles",1,Pac-12 Conference,428,73,403,90,213,62,215,83,197,86,206,95,19659,91,8421,89,11238,93
"University of California, Riverside",1,Big West Conference,168,63,166,83,79,53,89,71,76,75,90,90,16758,72,7774,70,8984,75
"University of California, Santa Barbara",1,Big West Conference,327,65,304,83,172,59,155,73,162,78,142,88,12447,81,5688,78,6759,84
Loyola Marymount University,1,West Coast Conference,225,72,220,92,99,69,126,75,98,90,122,94,5301,80,2205,79,3096,80
University of the Pacific,1,West Coast Conference,221,66,219,90,87,59,134,71,88,88,131,92,3021,68,1375,64,1646,72
Pepperdine University,1,West Coast Conference,137,69,128,90,59,53,78,82,49,90,79,90,2886,85,1249,81,1637,88
San Diego State University,1,Mountain West Conference,384,64,416,80,156,53,228,71,172,72,244,86,13346,71,5510,68,7836,73
University of San Diego,1,West Coast Conference,174,70,270,90,63,44,111,84,154,84,116,97,4628,79,1911,76,2717,81
University of San Francisco,1,West Coast Conference,177,60,154,89,83,58,94,62,84,86,70,93,4470,73,1504,69,2966,75
San Jose State University,1,Mountain West Conference,267,64,278,82,104,61,163,66,133,77,145,88,17191,58,8392,54,8799,62
Santa Clara University,1,West Coast Conference,182,74,191,91,83,71,99,77,87,87,104,93,4878,87,2408,85,2470,89
Saint Mary's College of California,1,West Coast Conference,198,71,156,90,71,63,127,75,65,89,91,91,2434,72,926,65,1508,76
University of Southern California,1,Pac-12 Conference,342,75,354,87,192,68,150,85,194,82,160,93,11486,92,5393,90,6093,93
"University of Colorado, Boulder",1,Pac-12 Conference,220,66,197,90,123,60,97,73,103,85,94,96,22128,70,11465,68,10663,73
Colorado State University,1,Mountain West Conference,242,67,246,85,109,62,133,71,118,80,128,89,17343,67,7711,64,9632,69
University of Denver,1,The Summit League,280,73,241,95,145,68,135,79,122,93,119,96,4772,77,2128,74,2644,79
University of Northern Colorado,1,Big Sky Conference,256,66,243,89,133,53,123,80,129,83,114,96,8831,48,3414,40,5417,53
U.S. Air Force Academy,1,Mountain West Conference,,,705,86,,,,,492,85,213,87,4941,81,3869,81,1072,81
Central Connecticut State University,1,Northeast Conference,237,57,228,76,129,44,108,73,127,64,101,91,5277,54,2832,50,2445,59
University of Connecticut,1,American Athletic Conference,333,68,331,89,159,62,174,75,183,84,148,95,13281,82,6620,80,6661,85
Fairfield University,1,Metro Atlantic Athletic Conference,271,83,251,97,114,79,157,87,108,95,143,98,3575,81,1452,79,2123,83
University of Hartford,1,America East Conference,155,69,124,94,76,63,79,75,55,91,69,96,4600,57,2289,56,2311,59
Quinnipiac University,1,Metro Atlantic Athletic Conference,266,72,228,93,112,63,154,79,92,88,136,97,6215,76,2331,73,3884,78
Sacred Heart University,1,Northeast Conference,364,72,314,89,198,66,166,79,172,84,142,96,3842,66,1473,61,2369,69
Yale University,1,The Ivy League,,,779,99,,,,,427,98,352,100,3965,97,1953,96,2012,98
Delaware State University,1,Mid-Eastern Athletic Conf.,172,55,161,80,75,53,97,56,79,73,82,87,3409,41,1262,33,2147,45
University of Delaware,1,Colonial Athletic Association,366,73,358,85,167,65,199,80,173,75,185,94,14576,82,6125,79,8451,85
American University,1,Patriot League,146,74,171,96,49,73,97,74,70,97,101,96,6131,81,2395,80,3736,82
George Washington University,1,Atlantic 10 Conference,264,82,260,94,104,77,160,85,106,92,154,95,9590,82,4140,80,5450,83
Georgetown University,1,Big East Conference,295,88,279,97,142,85,153,92,133,94,146,99,6285,94,2878,94,3407,95
Howard University,1,Mid-Eastern Athletic Conf.,207,69,216,81,107,61,100,78,109,75,107,88,6075,61,1867,54,4208,65
Bethune-Cookman University,1,Mid-Eastern Athletic Conf.,185,51,212,74,112,48,73,55,141,69,71,83,3446,39,1299,32,2147,43
University of Central Florida,1,American Athletic Conference,291,58,254,89,148,50,143,66,132,82,122,98,24573,70,11501,65,13072,74
Florida A&M University,1,Mid-Eastern Athletic Conf.,164,53,205,71,84,42,80,65,121,61,84,85,9135,42,3623,35,5512,46
Florida Atlantic University,1,Conference USA,241,58,241,80,135,54,106,63,138,76,103,86,10908,49,5089,44,5819,54
Florida International University,1,Conference USA,271,61,283,83,133,50,138,70,143,73,140,93,13976,56,6395,49,7581,63
Florida State University,1,Atlantic Coast Conference,289,60,319,82,176,49,113,75,185,73,134,94,23029,80,9484,76,13545,82
University of Florida,1,Southeastern Conference,419,63,376,85,200,49,219,75,175,74,201,95,25361,87,10405,84,14956,89
Jacksonville University,1,ASUN Conference,250,54,278,83,127,40,123,68,166,75,112,96,2348,42,1215,38,1133,46
University of Miami (Florida),1,Atlantic Coast Conference,240,59,226,90,120,54,120,63,115,87,111,94,8129,82,4100,79,4029,85
University of North Florida,1,ASUN Conference,192,65,232,88,78,53,114,74,100,80,132,93,7371,55,3227,49,4144,60
University of South Florida,1,American Athletic Conference,283,67,324,84,164,62,119,75,197,77,127,95,15521,68,6606,63,8915,72
Stetson University,1,ASUN Conference,185,63,161,90,69,58,116,66,63,86,98,93,2379,63,975,62,1404,63
Georgia Institute of Technology,1,Atlantic Coast Conference,286,70,246,89,180,66,106,76,152,86,94,95,10679,84,6967,82,3712,89
Georgia Southern University,1,Sun Belt Conference,293,60,283,80,159,52,134,69,163,71,120,92,13707,51,7104,44,6603,58
Georgia State University,1,Sun Belt Conference,191,68,221,81,75,60,116,72,99,74,122,86,11182,53,4833,48,6349,58
University of Georgia,1,Southeastern Conference,428,67,418,84,202,55,226,77,202,73,216,94,19590,85,7510,83,12080,86
Mercer University,1,Southern Conference,197,61,180,91,99,56,98,66,89,88,91,95,2403,63,1090,59,1313,67
Savannah State University,1,Mid-Eastern Athletic Conf.,242,44,256,54,155,37,87,56,168,45,88,70,3530,28,1661,23,1869,33
"University of Hawaii, Manoa",1,Big West Conference,216,63,268,85,104,53,112,71,141,80,127,91,7329,58,3278,55,4051,60
Boise State University,1,Mountain West Conference,289,69,269,90,113,65,176,71,104,87,165,92,8529,40,3934,36,4595,43
Idaho State University,1,Big Sky Conference,200,56,200,84,74,51,126,59,98,80,102,88,4068,29,1848,27,2220,31
University of Idaho,1,Big Sky Conference,186,56,231,75,85,42,101,67,139,63,92,92,6699,57,3499,53,3200,61
Bradley University,1,Missouri Valley Conference,144,75,131,94,73,67,71,83,67,90,64,98,4284,74,1929,71,2355,76
Chicago State University,1,Western Athletic Conference,70,43,107,79,34,32,36,53,61,75,46,85,1904,14,567,14,1337,14
DePaul University,1,Big East Conference,175,71,158,92,69,58,106,79,62,85,96,97,9768,72,4057,69,5711,74
Eastern Illinois University,1,Ohio Valley Conference,293,67,290,83,176,63,117,73,184,77,106,92,6200,58,2426,55,3774,60
University of Illinois at Chicago,1,Horizon League,166,75,187,84,77,68,89,82,90,77,97,91,12347,59,5567,57,6780,60
University of Illinois Urbana-Champaign,1,Big Ten Conference,332,77,321,91,181,67,151,88,173,86,148,97,28347,85,15333,82,13014,89
Illinois State University,1,Missouri Valley Conference,305,69,308,88,146,54,159,83,154,79,154,97,12935,71,5155,67,7780,74
Loyola University Chicago,1,Missouri Valley Conference,168,77,139,99,72,74,96,79,59,97,80,100,8245,75,2854,74,5391,75
Northern Illinois University,1,Mid-American Conference,281,63,258,86,168,52,113,80,152,79,106,96,11043,48,5444,45,5599,50
Northwestern University,1,Big Ten Conference,385,91,373,98,184,91,201,91,178,97,195,98,8432,93,4076,92,4356,95
Southern Illinois University at Carbondale,1,Missouri Valley Conference,282,67,269,86,163,63,119,71,166,84,103,88,10787,44,5822,40,4965,48
Southern Illinois University Edwardsville,1,Ohio Valley Conference,211,67,186,92,115,62,96,74,101,89,85,95,7847,49,3428,47,4419,50
Western Illinois University,1,The Summit League,278,63,284,86,160,58,118,70,179,79,105,96,7087,53,3543,51,3544,54
Ball State University,1,Mid-American Conference,319,71,321,87,145,66,174,76,164,82,157,92,15159,61,6129,58,9030,63
Butler University,1,Big East Conference,155,75,284,89,74,72,81,79,185,85,99,96,3852,77,1541,73,2311,79
University of Evansville,1,Missouri Valley Conference,203,68,153,99,93,63,110,73,68,97,85,100,2615,69,1021,65,1594,71
Purdue University Fort Wayne,1,The Summit League,185,61,169,82,78,56,107,64,88,76,81,89,7095,25,3510,24,3585,27
Indiana University-Purdue University Indianapolis,1,Horizon League,201,63,172,89,75,68,126,60,69,87,103,90,9389,47,3977,46,5412,48
Indiana State University,1,Missouri Valley Conference,260,59,259,82,135,55,125,64,155,74,104,93,8693,39,4104,37,4589,41
"Indiana University, Bloomington",1,Big Ten Conference,417,69,352,91,212,63,205,75,174,86,178,96,29190,77,14060,74,15130,80
University of Notre Dame,1,Atlantic Coast Conference,396,93,392,98,216,91,180,95,218,97,174,99,8136,96,4351,95,3785,96
Valparaiso University,1,Missouri Valley Conference,197,74,322,83,80,63,117,81,202,77,120,93,2715,68,1312,62,1403,74
Drake University,1,Missouri Valley Conference,150,77,248,90,58,76,92,78,161,88,87,92,3223,70,1351,70,1872,69
Iowa State University,1,Big 12 Conference,304,70,301,88,143,57,161,82,144,78,157,97,18342,72,9978,69,8364,76
University of Iowa,1,Big Ten Conference,431,76,401,90,225,72,206,80,216,86,185,95,17076,72,7924,70,9152,74
University of Northern Iowa,1,Missouri Valley Conference,266,70,243,85,136,61,130,80,127,77,116,94,7718,66,2923,63,4795,68
University of Kansas,1,Big 12 Conference,347,63,326,83,155,53,192,71,136,79,190,85,15309,62,7470,59,7839,65
Kansas State University,1,Big 12 Conference,312,68,343,85,107,50,205,78,141,79,202,90,13841,62,6869,59,6972,64
Wichita State University,1,American Athletic Conference,180,57,182,82,93,51,87,64,95,78,87,87,4944,45,2318,41,2626,49
Eastern Kentucky University,1,Ohio Valley Conference,227,60,226,86,121,56,106,65,135,82,91,91,8552,45,3735,40,4817,49
University of Kentucky,1,Southeastern Conference,385,61,328,88,224,52,161,73,189,81,139,96,16356,62,7878,58,8478,66
University of Louisville,1,Atlantic Coast Conference,423,69,399,88,199,64,224,73,198,82,201,95,9981,53,4815,51,5166,56
Morehead State University,1,Ohio Valley Conference,173,62,253,76,67,46,106,72,161,66,92,92,4297,45,1845,40,2452,48
Murray State University,1,Ohio Valley Conference,203,62,236,86,84,56,119,66,127,82,109,91,5688,50,2241,43,3447,54
Northern Kentucky University,1,Horizon League,190,63,197,77,73,48,117,72,86,66,111,86,8510,38,3790,35,4720,42
Western Kentucky University,1,Conference USA,298,63,250,85,168,56,130,73,149,77,101,96,10154,51,4290,46,5864,55
Grambling State University,1,Southwestern Athletic Conf.,188,54,210,65,92,50,96,58,105,59,105,70,2894,33,1273,28,1621,37
Louisiana State University,1,Southeastern Conference,336,59,294,89,184,51,152,68,157,83,137,95,20667,65,9621,62,11046,67
Louisiana Tech University,1,Conference USA,242,60,265,79,127,50,115,71,147,71,118,89,5810,53,3333,49,2477,60
McNeese State University,1,Southland Conference,257,65,274,83,118,64,139,65,146,75,128,91,4994,42,2039,37,2955,45
University of New Orleans,1,Southland Conference,83,20,87,66,48,21,35,20,56,66,31,65,4495,34,2307,32,2188,37
Nicholls State University,1,Southland Conference,240,53,250,80,125,50,115,56,148,80,102,81,4162,44,1634,36,2528,48
University of Louisiana at Monroe,1,Sun Belt Conference,244,55,257,76,119,61,125,50,150,76,107,76,4737,41,1704,38,3033,43
Northwestern State University,1,Southland Conference,245,57,266,78,137,48,108,68,172,70,94,93,4308,37,1598,34,2710,38
Southeastern Louisiana University,1,Southland Conference,254,58,290,78,141,54,113,63,178,74,112,84,9763,39,4014,33,5749,43
"Southern University, Baton Rouge",1,Southwestern Athletic Conf.,220,46,225,54,113,34,107,59,123,41,102,70,3701,31,1606,26,2095,35
University of Louisiana at Lafayette,1,Sun Belt Conference,270,57,287,76,148,55,122,61,172,73,115,81,10963,46,4842,41,6121,49
Tulane University,1,American Athletic Conference,218,71,193,93,129,64,89,81,108,90,85,98,6322,83,2688,82,3634,84
"University of Maine, Orono",1,America East Conference,261,66,242,86,148,59,113,75,145,80,97,95,7033,59,3663,58,3370,60
Coppin State University,1,Mid-Eastern Athletic Conf.,103,39,98,63,39,33,64,42,43,63,55,64,2095,19,599,16,1496,20
Loyola University Maryland,1,Patriot League,175,86,170,98,80,84,95,88,79,96,91,100,4124,82,1593,80,2531,82
"University of Maryland, Baltimore County",1,America East Conference,304,61,257,83,143,58,161,64,125,80,132,86,5977,63,3476,57,2501,70
"University of Maryland, College Park",1,Big Ten Conference,445,67,369,84,238,59,207,75,209,78,160,93,15987,86,8498,84,7489,88
University of Maryland Eastern Shore,1,Mid-Eastern Athletic Conf.,84,42,94,80,36,47,48,38,50,72,44,89,3606,36,1418,31,2188,39
Morgan State University,1,Mid-Eastern Athletic Conf.,127,46,155,62,69,42,58,52,92,55,63,71,4994,33,2189,27,2805,38
Mount St. Mary's University,1,Northeast Conference,221,72,169,95,101,65,120,78,74,91,95,98,1870,67,829,62,1041,70
Towson University,1,Colonial Athletic Association,369,69,335,87,178,57,191,81,147,80,188,92,10189,70,3604,65,6585,73
U.S. Naval Academy,1,Patriot League,,,807,92,,,,,551,91,256,95,3707,86,2960,86,747,86
Boston College,1,Atlantic Coast Conference,331,82,383,95,145,72,186,89,188,91,195,98,9153,92,4308,91,4845,93
Boston University,1,Patriot League,271,80,242,95,108,73,163,85,88,91,154,97,16637,86,6508,85,10129,87
Harvard University,1,The Ivy League,28,93,783,100,23,91,5,100,430,100,353,100,6665,97,3335,96,3330,98
College of the Holy Cross,1,Patriot League,362,87,321,98,193,85,169,89,170,97,151,99,2962,92,1400,92,1562,92
University of Massachusetts Lowell,1,America East Conference,173,70,162,83,90,57,83,84,79,75,83,90,6033,57,3859,53,2174,63
"University of Massachusetts, Amherst",1,Atlantic 10 Conference,353,68,320,84,174,61,179,74,158,79,162,90,17367,77,8415,76,8952,78
Northeastern University,1,Colonial Athletic Association,227,74,198,90,112,64,115,83,88,85,110,95,11643,85,5777,82,5866,87
Central Michigan University,1,Mid-American Conference,308,65,280,82,171,55,137,77,157,71,123,97,11719,57,5223,51,6496,62
University of Detroit Mercy,1,Horizon League,224,71,205,90,100,69,124,73,97,85,108,94,2262,61,873,57,1389,64
Eastern Michigan University,1,Mid-American Conference,307,63,284,85,154,54,153,72,149,77,135,94,8436,40,3461,37,4975,43
University of Michigan,1,Big Ten Conference,421,81,392,93,240,76,181,86,223,90,169,96,24401,91,12202,89,12199,93
Michigan State University,1,Big Ten Conference,445,75,414,88,236,69,209,82,218,84,196,93,29290,79,13552,76,15738,81
Oakland University,1,Horizon League,227,66,201,84,97,61,130,69,88,80,113,88,9036,46,3492,42,5544,48
Western Michigan University,1,Mid-American Conference,304,66,272,83,170,55,134,81,147,78,125,90,13438,53,6518,49,6920,57
"University of Minnesota, Twin Cities",1,Big Ten Conference,500,80,480,93,273,75,227,85,267,90,213,97,21131,79,9866,77,11265,80
Alcorn State University,1,Southwestern Athletic Conf.,201,52,213,74,111,44,90,61,121,70,92,79,2161,34,907,28,1254,38
Jackson State University,1,Southwestern Athletic Conf.,172,57,192,82,92,48,80,68,101,76,91,88,3646,39,1562,33,2084,42
University of Mississippi,1,Southeastern Conference,288,61,279,85,160,54,128,71,161,79,118,93,11468,60,5393,57,6075,63
Mississippi Valley State University,1,Southwestern Athletic Conf.,118,45,141,89,64,34,54,57,83,86,58,93,1241,28,624,24,617,31
Mississippi State University,1,Southeastern Conference,314,63,282,89,178,55,136,74,154,85,128,93,10497,59,5203,57,5294,61
The University of Southern Mississippi,1,Conference USA,224,61,227,86,121,55,103,68,134,79,93,97,6378,47,2292,41,4086,51
"University of Missouri, Columbia",1,Southeastern Conference,374,71,353,91,206,68,168,76,200,88,153,95,23237,69,10825,65,12412,72
University of Missouri-Kansas City,1,Western Athletic Conference,169,66,193,91,56,57,113,70,79,86,114,95,4170,50,1591,48,2579,51
Saint Louis University,1,Atlantic 10 Conference,235,73,210,93,94,65,141,78,85,91,125,95,6509,75,2723,72,3786,77
Southeast Missouri State University,1,Ohio Valley Conference,199,67,259,80,94,59,105,74,144,70,115,93,6861,50,2774,47,4087,53
Missouri State University,1,Missouri Valley Conference,315,63,283,83,162,56,153,70,159,76,124,91,10368,54,4299,49,6069,58
Montana State University-Bozeman,1,Big Sky Conference,211,67,218,82,116,62,95,73,130,75,88,91,7793,53,4525,48,3268,58
University of Montana,1,Big Sky Conference,213,63,205,77,117,52,96,77,119,66,86,92,6668,49,3207,43,3461,54
Creighton University,1,Big East Conference,191,72,175,97,81,69,110,75,86,95,89,98,4017,78,1614,75,2403,80
University of Nebraska Omaha,1,The Summit League,280,46,195,85,150,36,130,58,92,85,103,85,6499,46,3106,41,3393,50
"University of Nebraska, Lincoln",1,Big Ten Conference,337,72,327,90,186,65,151,81,193,87,134,96,16224,67,8458,63,7766,71
"University of Nevada, Las Vegas",1,Mountain West Conference,255,60,289,78,139,50,116,72,165,69,124,90,11706,41,5226,37,6480,43
"University of Nevada, Reno",1,Mountain West Conference,211,55,255,77,99,44,112,64,145,72,110,85,9913,56,4628,52,5285,60
Dartmouth College,1,The Ivy League,,,754,99,,,,,434,98,320,100,4433,95,2221,95,2212,96
University of New Hampshire,1,America East Conference,286,79,260,93,132,77,154,81,120,92,140,95,9348,77,4591,76,4757,78
"Fairleigh Dickinson University, Metropolitan Campus",1,Northeast Conference,160,57,135,88,66,53,94,60,57,84,78,91,1876,48,776,44,1100,51
Monmouth University,1,Metro Atlantic Athletic Conference,328,69,301,91,162,69,166,69,153,89,148,93,3864,69,1570,66,2294,70
New Jersey Institute of Technology,1,ASUN Conference,172,59,157,80,96,51,76,70,87,75,70,86,3404,61,2691,58,713,72
Princeton University,1,The Ivy League,18,94,755,98,15,93,,,426,97,329,99,5151,97,2604,96,2547,98
Rider University,1,Metro Atlantic Athletic Conference,244,67,195,93,119,63,125,71,94,88,101,98,3850,64,1561,62,2289,65
"Rutgers, The State University of New Jersey, New Brunswick",1,Big Ten Conference,405,69,367,87,219,59,186,82,193,78,174,97,22819,80,11666,77,11153,83
Saint Peter's University,1,Metro Atlantic Athletic Conference,211,68,188,92,88,63,123,72,85,88,103,95,2000,54,909,50,1091,57
Seton Hall University,1,Big East Conference,202,74,175,95,85,64,117,81,69,91,106,97,4628,65,1979,62,2649,67
University of New Mexico,1,Mountain West Conference,329,57,323,79,168,45,161,69,180,70,143,90,13224,48,5929,43,7295,52
New Mexico State University,1,Western Athletic Conference,246,60,269,80,82,49,164,65,131,69,138,90,9048,45,4202,41,4846,48
Canisius College,1,Metro Atlantic Athletic Conference,190,78,191,93,87,75,103,81,97,93,94,94,3028,70,1421,69,1607,70
Colgate University,1,Patriot League,266,87,337,97,154,84,112,92,194,95,143,100,3097,91,1437,90,1660,91
Columbia University-Barnard College,1,The Ivy League,,,618,99,,,,,328,98,290,100,5585,94,2902,94,2683,95
Cornell University,1,The Ivy League,,,706,95,,,,,367,94,339,97,12778,93,6383,92,6395,95
Fordham University,1,Atlantic 10 Conference,292,84,290,94,162,81,130,88,154,93,136,96,7490,80,3510,79,3980,80
Hofstra University,1,Colonial Athletic Association,240,63,202,91,127,51,113,77,102,84,100,98,6285,62,2842,58,3443,65
Iona College,1,Metro Atlantic Athletic Conference,221,70,227,91,92,65,129,73,110,89,117,93,3395,64,1460,60,1935,67
Long Island University-Brooklyn Campus,1,Northeast Conference,181,63,179,92,75,55,106,69,78,85,101,97,3036,29,874,24,2162,30
Manhattan College,1,Metro Atlantic Athletic Conference,233,76,210,97,118,75,115,77,108,94,102,100,2879,73,1508,72,1371,75
Marist College,1,Metro Atlantic Athletic Conference,311,79,412,90,134,71,177,85,248,85,164,96,4322,81,1820,78,2502,83
Niagara University,1,Metro Atlantic Athletic Conference,225,68,194,92,94,61,131,73,83,89,111,95,2700,65,1079,62,1621,67
St. Bonaventure University,1,Atlantic 10 Conference,208,74,191,93,86,72,122,75,93,89,98,96,2012,66,948,63,1064,69
St. Francis College Brooklyn,1,Northeast Conference,119,73,146,91,60,75,59,71,77,90,69,93,2159,52,1019,49,1140,55
Siena College,1,Metro Atlantic Athletic Conference,284,79,250,92,115,70,169,85,98,86,152,97,3156,77,1463,73,1693,80
St. John's University (New York),1,Big East Conference,180,66,190,93,91,52,89,81,88,90,102,95,12049,58,5729,54,6320,62
University at Albany,1,America East Conference,314,68,288,89,167,66,147,71,156,85,132,95,9374,66,4747,62,4627,70
Binghamton University,1,America East Conference,299,73,276,91,169,63,130,85,149,85,127,97,9119,81,4877,78,4242,86
"University at Buffalo, the State University of New York",1,Mid-American Conference,331,63,229,83,184,55,147,73,121,70,108,97,12559,74,6768,70,5791,78
Stony Brook University,1,America East Conference,264,62,245,86,136,58,128,66,133,81,112,92,10920,70,6062,65,4858,76
Syracuse University,1,Atlantic Coast Conference,309,72,292,92,139,70,170,74,144,88,148,96,13245,82,5700,79,7545,83
U.S. Military Academy,1,Patriot League,,,624,90,,,,,440,89,184,93,11922,89,10086,89,1836,89
Wagner College,1,Northeast Conference,311,67,268,88,164,57,147,78,144,80,124,97,1954,67,748,57,1206,72
Appalachian State University,1,Sun Belt Conference,303,63,276,81,178,60,125,69,167,75,109,89,11286,71,5285,66,6001,77
Campbell University,1,Big South Conference,272,62,291,84,134,51,138,72,166,76,125,94,3219,52,1430,47,1789,55
Davidson College,1,Atlantic 10 Conference,165,92,294,97,83,90,82,94,198,95,96,100,1968,94,973,94,995,94
Duke University,1,Atlantic Coast Conference,346,89,360,98,183,86,163,92,202,98,158,98,6904,95,3422,93,3482,96
East Carolina University,1,American Athletic Conference,301,69,303,84,167,60,134,80,171,77,132,93,16537,61,7002,55,9535,66
Elon University,1,Colonial Athletic Association,257,81,250,95,138,78,119,83,141,95,109,95,5357,82,2171,79,3186,85
Gardner-Webb University,1,Big South Conference,353,63,310,83,213,56,140,75,186,76,124,94,1828,49,802,43,1026,54
High Point University,1,Big South Conference,153,58,131,89,73,51,80,65,67,85,64,94,4411,64,1716,61,2695,66
North Carolina A&T State University,1,Mid-Eastern Athletic Conf.,184,53,179,68,105,51,79,56,112,63,67,75,7373,44,3407,38,3966,50
University of North Carolina Asheville,1,Big South Conference,154,73,134,95,87,67,67,81,73,92,61,98,2351,62,972,58,1379,64
"University of North Carolina, Chapel Hill",1,Atlantic Coast Conference,466,68,433,83,263,57,203,82,234,75,199,93,15770,91,6450,88,9320,92
The University of North Carolina at Charlotte,1,Conference USA,210,69,198,90,101,64,109,73,103,85,95,95,12298,55,6013,52,6285,58
The University of North Carolina at Greensboro,1,Southern Conference,189,50,147,84,105,42,84,60,79,78,68,90,9886,55,3105,49,6781,57
North Carolina Central University,1,Mid-Eastern Athletic Conf.,179,54,195,80,108,49,71,62,130,73,65,94,4833,44,1657,37,3176,47
North Carolina State University,1,Atlantic Coast Conference,371,64,341,86,216,56,155,75,206,80,135,95,18401,77,10044,75,8357,80
University of North Carolina Wilmington,1,Colonial Athletic Association,237,69,211,87,123,63,114,76,110,80,101,95,7982,71,3157,66,4825,75
Wake Forest University,1,Atlantic Coast Conference,249,76,235,94,150,71,99,85,141,90,94,99,4839,88,2285,88,2554,89
Western Carolina University,1,Southern Conference,263,59,213,86,138,54,125,65,114,82,99,90,5697,58,2640,53,3057,62
University of North Dakota,1,Big Sky Conference,324,65,222,82,160,63,164,68,126,75,96,90,8037,54,4213,51,3824,57
North Dakota State University,1,The Summit League,279,67,246,85,170,65,109,70,155,79,91,97,9850,56,5409,54,4441,58
University of Akron,1,Mid-American Conference,297,66,267,84,158,55,139,78,143,75,124,95,13912,43,7244,40,6668,46
Bowling Green State University,1,Mid-American Conference,318,74,296,91,166,71,152,78,161,86,135,97,13878,55,6093,50,7785,59
University of Cincinnati,1,American Athletic Conference,313,68,298,89,148,62,165,74,158,83,140,96,14871,66,7898,64,6973,69
Cleveland State University,1,Horizon League,222,71,185,94,116,55,106,88,81,89,104,98,7762,46,4373,45,3389,46
University of Dayton,1,Atlantic 10 Conference,185,77,309,93,75,72,110,81,205,92,104,95,7658,77,3815,74,3843,80
Kent State University,1,Mid-American Conference,300,69,289,86,165,63,135,77,163,80,126,94,15826,56,6167,50,9659,59
Miami University (Ohio),1,Mid-American Conference,343,78,318,91,182,73,161,84,172,87,146,96,13957,79,6458,76,7499,82
The Ohio State University,1,Big Ten Conference,601,73,587,86,332,64,269,84,323,81,264,92,26592,83,13456,80,13136,86
Ohio University,1,Mid-American Conference,311,74,307,88,156,66,155,83,160,83,147,93,367,73,200,66,167,82
University of Toledo,1,Mid-American Conference,273,71,257,91,129,62,144,78,124,84,133,97,15516,43,7587,42,7929,43
Wright State University,1,Horizon League,196,64,187,84,96,64,100,64,96,86,91,82,10576,37,4588,36,5988,39
Xavier University,1,Big East Conference,212,77,185,96,111,72,101,83,93,94,92,99,4181,72,1961,70,2220,73
Youngstown State University,1,Horizon League,273,60,269,80,126,52,147,67,145,72,124,90,8722,33,4273,31,4449,34
Oklahoma State University,1,Big 12 Conference,274,47,255,73,169,43,105,54,170,66,85,86,12974,62,6304,58,6670,66
University of Oklahoma,1,Big 12 Conference,330,60,332,85,188,50,142,73,196,78,136,95,15111,67,7054,64,8057,70
Oral Roberts University,1,The Summit League,143,51,151,82,73,44,70,59,85,82,66,82,1570,55,678,53,892,56
The University of Tulsa,1,American Athletic Conference,269,72,267,87,125,66,144,76,128,79,139,94,2642,70,1447,67,1195,73
Oregon State University,1,Pac-12 Conference,284,54,256,80,148,41,136,68,127,68,129,91,13135,64,6817,61,6318,68
University of Oregon,1,Pac-12 Conference,352,66,333,83,168,57,184,75,160,74,173,92,15993,71,7479,69,8514,73
Portland State University,1,Big Sky Conference,191,57,207,77,85,46,106,65,106,66,101,89,4335,43,1984,39,2351,46
University of Portland,1,West Coast Conference,162,78,151,97,82,74,80,81,73,97,78,96,3512,81,1325,78,2187,82
Bucknell University,1,Patriot League,269,89,277,96,130,87,139,91,142,94,135,99,3742,89,1773,88,1969,89
Drexel University,1,Colonial Athletic Association,279,77,264,89,133,67,146,86,123,80,141,96,10397,69,5979,66,4418,74
Duquesne University,1,Atlantic 10 Conference,275,72,242,90,129,68,146,76,114,86,128,94,4879,76,2023,73,2856,78
La Salle University,1,Atlantic 10 Conference,303,80,286,92,128,74,175,83,121,88,165,95,3507,66,1432,65,2075,67
Lafayette College,1,Patriot League,237,87,241,98,146,82,91,95,147,97,94,100,2501,90,1340,87,1161,92
Lehigh University,1,Patriot League,325,82,297,90,185,78,140,88,170,85,127,97,4805,87,2739,85,2066,90
Pennsylvania State University,1,Big Ten Conference,430,79,432,90,241,73,189,86,239,87,193,94,28470,86,14708,82,13762,89
University of Pennsylvania,1,The Ivy League,188,95,720,97,100,93,88,98,392,95,328,99,9566,95,4648,94,4918,97
University of Pittsburgh,1,Atlantic Coast Conference,320,64,281,88,187,56,133,76,166,82,115,97,14537,82,7104,79,7433,85
Robert Morris University,1,Northeast Conference,370,69,267,90,177,59,193,78,121,83,146,95,3044,61,1738,58,1306,64
Saint Francis University (Pennsylvania),1,Northeast Conference,355,68,295,90,146,66,209,70,120,88,175,91,1692,68,709,62,983,73
Saint Joseph's University,1,Atlantic 10 Conference,289,80,257,94,160,74,129,87,140,90,117,99,4999,78,2395,77,2604,79
Temple University,1,American Athletic Conference,307,74,271,87,145,70,162,77,128,83,143,90,16896,70,7840,67,9056,73
Villanova University,1,Big East Conference,265,81,287,94,141,76,124,86,146,91,141,98,6527,90,3264,89,3263,92
Brown University,1,The Ivy League,,,785,98,,,,,395,98,390,99,6034,96,2894,95,3140,96
Bryant University,1,Northeast Conference,349,75,301,93,204,68,145,85,171,88,130,99,3293,78,1952,76,1341,82
Providence College,1,Big East Conference,306,80,280,94,144,77,162,83,133,92,147,97,4023,85,1689,84,2334,85
University of Rhode Island,1,Atlantic 10 Conference,276,63,257,85,132,52,144,74,131,77,126,93,11647,63,5165,59,6482,65
Charleston Southern University,1,Big South Conference,233,51,239,72,127,45,106,58,142,65,97,82,2582,36,1007,32,1575,38
College of Charleston (South Carolina),1,Colonial Athletic Association,221,69,175,86,104,65,117,73,84,79,91,92,8408,68,2769,66,5639,69
The Citadel,1,Southern Conference,240,67,190,86,180,62,60,82,136,83,54,94,2412,70,2254,70,158,73
Clemson University,1,Atlantic Coast Conference,396,67,305,92,214,62,182,74,163,90,142,94,12075,82,6211,78,5864,85
Furman University,1,Southern Conference,254,78,236,90,152,73,102,85,143,85,93,99,2880,83,1216,81,1664,84
Presbyterian College,1,Big South Conference,206,64,178,85,130,55,76,79,114,78,64,98,1345,67,644,60,701,74
"University of South Carolina, Columbia",1,Southeastern Conference,378,67,327,94,191,59,187,75,149,91,178,96,16688,73,7498,69,9190,76
Coastal Carolina University,1,Sun Belt Conference,281,56,258,86,152,43,129,70,144,78,114,95,7529,43,3513,39,4016,47
South Carolina State University,1,Mid-Eastern Athletic Conf.,154,60,146,79,78,60,76,59,84,70,62,90,3273,37,1616,32,1657,42
University of South Carolina Upstate,1,ASUN Conference,216,47,176,82,100,52,116,42,94,77,82,89,3115,43,1060,35,2055,46
Winthrop University,1,Big South Conference,225,60,193,89,98,55,127,64,94,84,99,93,4063,55,1210,51,2853,57
Wofford College,1,Southern Conference,222,82,201,97,151,81,71,86,135,96,66,100,1681,80,838,80,843,81
South Dakota State University,1,The Summit League,330,73,329,85,175,68,155,79,180,78,149,94,8108,55,4034,53,4074,58
University of South Dakota,1,The Summit League,290,68,276,89,124,61,166,73,128,84,148,95,3840,53,1678,50,2162,56
Austin Peay State University,1,Ohio Valley Conference,234,61,227,83,122,57,112,64,125,76,102,91,4957,32,1960,30,2997,33
Belmont University,1,Ohio Valley Conference,163,84,175,97,70,83,93,85,80,96,95,97,4078,70,1729,68,2349,71
Lipscomb University,1,ASUN Conference,251,66,219,89,121,55,130,76,103,82,116,96,2545,58,1043,56,1502,60
East Tennessee State University,1,Southern Conference,193,58,195,77,93,49,100,65,92,70,103,84,8146,42,3589,37,4557,46
University of Memphis,1,American Athletic Conference,292,60,277,90,157,58,135,63,167,88,110,92,9169,43,3773,41,5396,45
Middle Tennessee State University,1,Conference USA,225,64,237,89,116,66,109,61,147,88,90,90,14330,44,6935,39,7395,49
University of Tennessee at Chattanooga,1,Southern Conference,207,64,202,84,121,62,86,67,123,79,79,91,8325,43,3540,41,4785,45
"University of Tennessee, Knoxville",1,Southeastern Conference,316,64,294,86,167,56,149,72,167,81,127,92,16272,70,8152,66,8120,73
University of Tennessee at Martin,1,Ohio Valley Conference,240,59,255,85,112,61,128,57,156,80,99,93,5214,48,2254,46,2960,50
Tennessee State University,1,Ohio Valley Conference,174,47,170,68,99,43,75,52,110,60,60,83,4833,33,1866,27,2967,37
Tennessee Technological University,1,Ohio Valley Conference,241,68,234,85,120,67,121,70,135,80,99,93,7395,51,4078,48,3317,54
Vanderbilt University,1,Southeastern Conference,255,85,233,97,136,79,119,91,119,96,114,98,6356,92,3160,91,3196,93
Abilene Christian University,1,Southland Conference,322,51,296,75,230,43,92,72,206,66,90,96,3774,62,1718,56,2056,66
Baylor University,1,Big 12 Conference,334,70,321,90,129,64,205,74,143,85,178,95,12438,73,5123,70,7315,75
Texas A&M University-Corpus Christi,1,Southland Conference,146,49,160,76,61,44,85,52,74,72,86,80,5352,37,2171,33,3181,40
Houston Baptist University,1,Southland Conference,188,60,191,82,82,50,106,68,92,74,99,90,2110,42,745,39,1365,44
University of Houston,1,American Athletic Conference,274,58,280,79,146,51,128,65,148,71,132,87,13595,51,6875,46,6720,56
University of the Incarnate Word,1,Southland Conference,263,59,326,81,170,60,93,58,211,80,115,82,3188,51,1168,46,2020,55
Lamar University,1,Southland Conference,180,54,242,79,87,51,93,57,160,73,82,91,6083,32,2628,30,3455,33
University of North Texas,1,Conference USA,230,62,254,83,93,58,137,64,107,77,147,87,14139,52,6279,46,7860,57
The University of Texas Rio Grande Valley,1,Western Athletic Conference,93,53,142,78,38,45,55,58,77,81,65,75,10807,42,4963,36,5844,47
Prairie View A&M University,1,Southwestern Athletic Conf.,221,51,262,66,119,46,102,57,150,61,112,73,7193,30,2909,25,4284,34
Rice University,1,Conference USA,250,81,242,93,151,72,99,96,140,89,102,98,3600,92,1837,90,1763,94
Sam Houston State University,1,Southland Conference,290,57,303,74,153,47,137,69,176,61,127,92,8413,52,3438,47,4975,56
Southern Methodist University,1,American Athletic Conference,250,67,261,84,120,61,130,72,135,77,126,91,5580,79,2642,76,2938,81
Stephen F. Austin State University,1,Southland Conference,299,52,291,70,152,41,147,62,170,58,121,88,9874,43,3560,36,6314,47
Texas State University,1,Sun Belt Conference,258,64,292,79,137,56,121,72,171,73,121,88,15812,54,6407,47,9405,58
"Texas A&M University, College Station",1,Southeastern Conference,396,70,416,83,201,59,195,81,208,75,208,91,34383,82,17443,78,16940,86
University of Texas at Arlington,1,Sun Belt Conference,168,57,186,84,76,55,92,58,97,86,89,82,9580,47,4703,42,4877,51
University of Texas at Austin,1,Big 12 Conference,396,68,369,88,219,59,177,80,198,81,171,95,28183,81,12909,78,15274,84
University of Texas at El Paso,1,Conference USA,177,58,213,84,82,45,95,68,110,77,103,91,9456,39,4654,34,4802,44
Texas Christian University,1,Big 12 Conference,303,65,303,84,150,56,153,74,165,76,138,93,7126,78,2771,75,4355,80
University of Texas at San Antonio,1,Conference USA,282,61,309,82,144,59,138,63,176,78,133,86,19025,34,9772,30,9253,37
Texas Southern University,1,Southwestern Athletic Conf.,250,46,259,67,105,41,145,50,132,64,127,70,4570,18,2027,16,2543,20
Texas Tech University,1,Big 12 Conference,260,62,288,84,147,52,113,75,162,77,126,93,18017,60,9359,56,8658,63
Brigham Young University,1,West Coast Conference,269,67,279,78,121,55,148,76,132,66,147,88,13052,81,3514,81,9538,81
Southern Utah University,1,Big Sky Conference,202,62,192,84,93,57,109,66,90,77,102,90,3705,41,1185,39,2520,42
Utah State University,1,Mountain West Conference,214,67,220,92,95,63,119,71,113,89,107,95,9153,48,3189,43,5964,50
Utah Valley University,1,Western Athletic Conference,205,59,209,78,78,49,127,65,93,70,116,84,5223,25,2783,22,2440,29
University of Utah,1,Pac-12 Conference,263,68,257,95,117,63,146,73,125,95,132,94,9146,61,4279,57,4867,65
Weber State University,1,Big Sky Conference,208,59,212,79,96,53,112,64,98,72,114,84,4887,36,2166,28,2721,42
University of Vermont,1,America East Conference,281,71,241,93,110,62,171,77,93,87,148,96,9940,75,4264,74,5676,77
College of William & Mary,1,Colonial Athletic Association,255,88,318,94,125,86,130,89,163,91,155,97,5642,91,2516,89,3126,93
George Mason University,1,Atlantic 10 Conference,219,74,226,89,103,64,116,83,108,83,118,94,10322,69,4913,64,5409,74
Hampton University,1,Mid-Eastern Athletic Conf.,167,61,180,79,77,56,90,66,98,72,82,87,4119,61,1758,57,2361,64
James Madison University,1,Colonial Athletic Association,307,79,306,89,122,70,185,85,132,81,174,95,15925,82,6055,79,9870,84
Liberty University,1,Big South Conference,258,71,273,87,131,60,127,83,146,82,127,94,13839,48,6264,44,7575,51
Longwood University,1,Big South Conference,185,69,154,90,73,55,112,79,59,80,95,96,4037,67,1309,60,2728,70
Norfolk State University,1,Mid-Eastern Athletic Conf.,163,54,193,67,88,50,75,59,120,63,73,75,3616,37,1645,30,1971,43
Old Dominion University,1,Conference USA,281,68,266,84,136,56,145,79,131,76,135,93,10661,52,5346,47,5315,58
Radford University,1,Big South Conference,224,69,160,90,94,65,130,72,83,84,77,96,7183,58,3014,51,4169,63
University of Richmond,1,Atlantic 10 Conference,236,82,224,92,121,79,115,84,122,87,102,98,3252,87,1426,86,1826,88
Virginia Polytechnic Institute and State University,1,Atlantic Coast Conference,389,67,321,92,224,64,165,71,190,89,131,95,20661,84,11576,80,9085,88
Virginia Commonwealth University,1,Atlantic 10 Conference,178,64,186,78,69,48,109,74,77,68,109,85,14696,62,6051,57,8645,65
University of Virginia,1,Atlantic Coast Conference,484,79,445,92,256,71,228,87,223,87,222,96,13161,94,5821,92,7340,95
Virginia Military Institute,1,Southern Conference,247,71,280,85,192,70,55,75,230,84,50,86,1709,75,1536,75,173,75
Eastern Washington University,1,Big Sky Conference,182,60,172,80,94,59,88,63,93,75,79,86,5943,47,2477,44,3466,50
Gonzaga University,1,West Coast Conference,147,76,201,99,73,67,74,85,105,99,96,98,4590,84,2121,82,2469,86
Seattle University,1,Western Athletic Conference,248,79,282,95,115,76,133,82,143,93,139,96,3517,76,1281,75,2236,77
Washington State University,1,Pac-12 Conference,302,60,280,81,151,54,151,66,147,78,133,85,14942,65,7259,62,7683,68
University of Washington,1,Pac-12 Conference,395,73,385,89,207,63,188,84,205,84,180,95,22297,84,10282,82,12015,86
Marshall University,1,Conference USA,284,65,281,86,151,56,133,76,142,80,139,91,7361,46,3232,43,4129,49
West Virginia University,1,Big 12 Conference,262,64,278,82,150,58,112,72,170,74,108,94,19459,57,10610,53,8849,62
Marquette University,1,Big East Conference,179,77,171,95,83,73,96,80,85,93,86,98,7880,80,3779,78,4101,82
University of Wisconsin-Green Bay,1,Horizon League,224,66,184,93,97,57,127,72,80,85,104,99,3797,49,1401,45,2396,52
University of Wisconsin-Madison,1,Big Ten Conference,394,72,363,90,217,68,177,76,200,86,163,94,23110,86,10863,84,12247,88
University of Wisconsin-Milwaukee,1,Horizon League,238,63,227,78,118,57,120,69,122,71,105,87,13452,45,6681,45,6771,46
University of Wyoming,1,Mountain West Conference,294,62,297,82,159,55,135,70,165,78,132,89,6212,56,3075,50,3137,61
Stanford University,1,Pac-12 Conference,468,94,456,97,236,92,232,97,227,96,229,98,6747,94,3491,93,3256,96
Purdue University,1,Big Ten Conference,312,73,319,85,186,66,126,84,195,79,124,95,25688,76,14441,74,11247,79
Florida Gulf Coast University,1,ASUN Conference,175,53,167,83,76,38,99,64,70,70,97,92,8420,46,3778,42,4642,50
Kennesaw State University,1,ASUN Conference,191,53,201,75,86,43,105,61,88,64,113,84,11140,42,4661,38,6479,46
